Get to the station
9,7,4
2,0,0,0,0,2,1
3,4,0,0,0,3,3
5,2,0,0,0,4,3
7,3,0,0,0,4,1
18,23,13,13,13,13,13,13,15
17,13,13,13,13,13,13,13,16
 1, 1, 1,18,13,13,13,15, 1
 1, 1, 1,17,13,13,13,12,15
18,13,13,13,13,15,102,14,14
14, 1, 1, 1,1,14,1,17,16
17,33,13,13,13,16, 1, 1, 1