Get to the station
9,7,4
2,1,0,0,0,2,1
1,4,0,0,0,2,2
5,5,0,0,0,2,1
6,6,0,0,0,2,1
1,1,102,1,18,13,13,15,1
18,23,13,13,16,18,13,12,15
14,18,13,15,18,12,15,14,14
17,12,13,12,12,12,12,16,14
18,12,13,12,12,16,17,15,14
17,12,13,12,12,13,13,12,16
102,17,31,16,17,13,13,16,1